> r Arianna - Loner Life in Another World                         c Caerick Sakai - In the Land of Leadale                        c Nicole Demara - Zenless Zone Zero
  r Chinatsu and Taiki - Blue Box                                 r Romarriche, Merold,  Puruth - Fragaria Memories               c Oga - Elf-san wa Yaserarenai                                No Choice
  c Percival Freeman - Tears of Themis                          > c Rouge the Bat - Sonic X                                       c Yoigahama Mitsuki - Princess Connect! Re:Dive
  c Amachi Niya - Blue Archive                                    c Geordo Stuart - My Next Life as a Villainess                > r Lu Guang  Cheng Xiaoshi - Link Click
> c Shigure Kira - Honkai Impact 3rd                              c Swain - League of Legends                                     c Yuu Ishigami - Kaguya-sama: Love is War
  c Nana Daiba - Revue Starlight                                > c Sombra - Overwatch                                            c Baishuo - Nikki Series
  c Tooru Ishikawa - Horimiya                                     c Hikari Yonaguni - World Dai Star                            > r MEIKO - Vocaloid
  c Hashirama Senju - Naruto                                    > c Genji Shimada - Overwatch                                     c Elze Silhoueska - Isekai Smartphone
  c Noor - I Parry Everything                                     c RX-0 Unicorn - Gundam Series                                > r Aether and Albedo - Genshin Impact
  c Kabru - Dungeon Meshi                                       > c Lantern - Honkai Impact 3rd                                   c Watchdog Man - One Punch Man
  c Koutarou Tatsumi - Zombieland Saga                          > c Izumi Rei - Slow Damage                                       c Kuya - NU: Carnival
> r Anne Faulkner - Paradox Live                                  c Kento Miura - Kimi ni Todoke                                  c Shishidou Izumi - Blue Archive
  c Nana - Mobile Legends                                         c Akihiko Sanada - Persona Series                             > r Maho Minami - BECK
  c Miu Amano - Blend S                                         > c Shea Haulia - Arifureta                                       c Luban No.7 - Honor of Kings
  r Team Urameshi - Yu Yu Hakusho                                 c Sombra - Overwatch                                          > c Semmelweis - Reverse: 1999
  c Raphael Walt - My Next Life as a Villainess                   c Ryuunosuke Akutagawa - Bungou Stray Dogs                      sr Saitama - One Punch Man                                    No Choice
> r Hokuto Hidaka - Ensemble Stars!                               c Raphael Walt - My Next Life as a Villainess                   c Sayori - Doki Doki Literature Club                          
  c Nokk - Tom Clancy's Series                                  > c Emil - NieR Series                                            c Velkhana - Monster Hunter Series                            
  c Campanella - Takt. Op                                         c Sarasa Saionji - Liar Liar                                  > r Nobara Kugisaki - Jujutsu Kaisen                            
  c Bambietta Basterbine - Bleach                               > c Golliwogg's Cakewalk - Takt Op. Series                        c Haruka Nanami - Uta no Prince-sama                          
> c Kiana Kaslana - Honkai Impact 3rd                             c Kaguya Otsutsuki - Naruto                                     c Silence Suzuka - Uma Musume: Pretty Derby                   
  c Ryuu Sanada - Kimi ni Todoke                                > c Vysache - Shangri-La Frontier                                 c COLOR - Gray Sheep                                          
  c U-1146 - Cells at Work!                                       c Xeno Wingfield - Dr. Stone                                  > r Akane Hououji - Megami no Café Terrace                      
  c Momoka Sonou - Girlish Number                               > c Flare Arlgrande Jioral - Redo of Healer                       c Gai Tsutsugami - Guilty Crown                               
  c Saori Takebe - Girls und Panzer                             > c Sumire Hanano - Chihayafuru                                   c Nika Nanaura - Gundam Series                                
  c Mikaela Hyakuya - Owari no Seraph                           > c Rika Saionji - Yamada-kun and the Seven Witches               c Futaba Isurugi - Revue Starlight                            
  c Ryoga Tosa - Paradox Live                                   > c Sayuri Akino - Hokkaido Gals                                  c Arc - Skeleton Knight in Another World                      
  c Iris Midgar - The Eminence in Shadow                        > c Mei Meido - Hyakkano                                          c Hashirama Senju - Naruto                                    
  c Sae Itoshi - Blue Lock                                      > c Sangonomiya Kokomi - Genshin Impact                           r Rin Okumura - Blue Exorcist                                 
> r Mualani, Kachina, and Kinich - Genshin Impact                 c Shino Kiryuu - Kanojo mo Kanojo                               c Roger - Mobile Legends                                      
  c Widowmaker - Overwatch                                      > c Asta - Honkai Star Rail                                       c Teruki Hanazawa - Mob Psycho 100                            
  c Mikie Okamine - Date A Live                                   c Pennel - Villains Are Destined to Die                       > r Noir Bouquet - Fragaria Memories                            
> r Dunyarzad Homayani - Genshin Impact                           r Ruri and Naomi - Hello World                                  c Shouko Makinohara - Seishun Buta Yarou                      
> c Sigewinne - Genshin Impact                                    c Sentouin D - Sentai Daishikkaku                               c Sugar - NIKKE                                               
> r S-Shark - One Piece                                           c Chaco - Fragaria Memories                                     c Quinella - Sword Art Online                                 
  c Lainie Cyan - Tenten Kakumei                                  c Kazusa Kyoyama - Blue Archive                               > c Ezra - Reverse: 1999                                        
  c Tsumugi Shiina - Liar Liar                                  > c Chamber - VALORANT                                            c JUNKY - Gray Sheep                                          
  c Kou Minamoto - Toilet-Bound Hanako-Kun                      > c Semmelweis - Reverse: 1999                                    r Hina  Licht - Plunderer                                     
  c Sumomo - Blue Archive                                       > c Avos Dilhevia - The Misfit of Demon King Academy              c Gaara - Naruto                                              
  c Kuon - Utawarerumono                                        > c Melissa - Mobile Legends                                      c Suigintou - Rozen Maiden                                    
  c Rumi Jinguuji - Futakire                                      c Ann Takamaki - Persona Series                               > r Akane Hououji - Megami no Café Terrace                      
  c Azami Suou - Raise wa Tanin ga Ii                             c Aika Natsukawa - The Dreaming Boy is a Realist              > r Shilial Lo Po Bia Jahad - Tower of God                      
  c Sherlock Holmes - Moriarty the Patriot                      > c Gilbert Bougainvillea - Violet Evergarden                     c Valiant - Kantai Collection                                 
  c Komachi Hikigaya - My Teen Romantic Comedy SNAFU              c Nana Hayashida - Golden Time                                > r Bane - Mobile Legends                                       
  c Clarence Clayden - Lovebrush Chronicles                       r Grey - Black Clover                                           r Moa Son - I Stole the First Ranker's Soul                   No Choice
  c Zantetsu Tsuguri - Blue Lock                                > c Ango Sakaguchi - Bungou Stray Dogs                            c Mari Iochi - Blue Archive                                   
  c Adolphe - Shuuen no Virche                                  > c Sumi Sakurasawa - Kanojo Okarishimasu                         c Rose Oriana - The Eminence in Shadow                        
  c Blade - NU: Carnival                                        > c Kaeru Yamatani - VTuber Legend                                c Sergei Dragunov - Tekken Series                             
  c Yesod - Library Of Ruina                                      c Jouji Nezu - Prison School                                  > c Mercuria - Reverse: 1999                                    
> r Natalia - Mobile Legends                                      c Light Yagami - Death Note                                     c Van Kiryuin - Uta no Prince-sama                            
  c Faye Valentine - Cowboy Bebop                                 c Yu Nina - Break My Case                                     > r Izumi Miyamura - Horimiya                                   
> r Veliona - Honkai Impact 3rd                                   r Deon Agriche - How to Protect the Heroine's Older Brother     c Mio Akiyama - K-ON!                                         
  c Sylphiette - Mushoku Tensei                                 > c Shokeika Deshi - Akudama Drive                                c James Sunderland - Silent Hill Series                       
  c Biron - Honor of Kings                                      > c Chizuru Yoshida - Kimi ni Todoke                              c Snake - Black Butler                                        
  c Aubrey - Omori                                              > c Yoshino Koiwai - Masamune-kun no Revenge                      c Tokage - Sumikko Gurashi                                    
> r Amame Amakata - Loner Life in Another World                   c Fam - Tensei Kizoku, Kantei Skill de Nariagaru                c Luck Voltia - Black Clover                                  
  c Eirai Sonokaze - VTuber Legend                                c Pavane - Takt Op. Series                                    > r Yozakura Kirara - Blue Archive                              
  c Kuzan - One Piece                                           > c Might Guy - Naruto                                            c Hanzou Hattori - The Irregular at Magic High School         
  c Edgar Redmond - Black Butler                                > c Raphiel Shiraha Ainsworth - Gabriel DropOut                   c Han Nari - Circles                                          
  c Luo Yi - Mobile Legends                                       c Hiromi Hamaguri - Selection Project                         > c Dainsleif - Genshin Impact                                  
> r Evelynn - League of Legends                                   c Satowa Houzuki - Kono Oto Tomare!                             c Lannion - The Promised Neverland                            
  c Chizuru Yoshida - Kimi ni Todoke                            > c Tao Fa - Jigokuraku                                           c Lyza - Made in Abyss                                        
  c Sherlock Holmes - Moriarty the Patriot                        c Pikero - Fragaria Memories                                  > r Rin Ko - Kingdom                                            
  c Rosell Kischa - Tensei Kizoku, Kantei Skill de Nariagaru      c Kaiji Itou - Kaiji                                          > r Nefertiri - Loner Life in Another World                     
  c Misha Necron - Misfit of Demon King Academy                   c High Elf Archer - Goblin Slayer                             > r Megu  Kasumi - Blue Archive                                 
  c Hareru Asagiri - VTuber Legend                              > c Damian Desmond - Spy x Family                                 c Nekoyamada Neko - My Deer Friend Nokotan                    
  c Brewmaster - Dota Series                                      c Nate River - Death note                                     > r Rin Ko - Kingdom                                            
  r Fade - VALORANT                                               r Xie Lian  Hua Cheng - Heaven Official's Blessing              c Mimimi Utsukushisugi - Hyakkano                             No Choice
  c Kagamine Rin - Vocaloid                                       c Tomoe Mami - Puella Magi Madoka Magica                      > r Romarriche, Merold,  Puruth - Fragaria Memories             
  c Tio Klarus - Arifureta                                      > c Toko Fukawa - Danganronpa                                     c Narmaya - Granblue Fantasy                                  
  c Haruna Kurodate - Blue Archive                              > c Saemonza - Girls und Panzer                                   c Miko Iino - Kaguya-sama: Love is War                        
  c Maho Akashi - D4DJ                                          > c Yve - Mobile Legends                                          c Yu Eunhee - Circles                                         
> r Aether and Albedo - Genshin Impact                            r Reloaded - The Detective is Already Dead                      c Rinko Yamato - My Love Story!!                              
  c Okita Soji - Fate Series                                    > c Sonohara Mizuka - Plunderer                                   c Vira - Granblue Fantasy                                     
  c Kojuurou Shuri - Masamune-kun no Revenge                    > c Valiant - Kantai Collection                                   c Garfiel Tinzel - Re:Zero                                    
> c Windsong - Reverse: 1999                                      c Cherino Renkawa - Blue Archive                                c Yuuki Konno - Sword Art Online                              
  c Light Yagami - Death Note                                   > c Takashi Natsume - Natsume Yuujinchou                          c Rentarou Aijou - Hyakkano                                   
  c Rouji Chante - Gundam Series                                > c Aira Shiratori - Dandadan                                     c Kosaki Onodera - Nisekoi                                    
> c Semmelweis - Reverse: 1999                                    c Masato Hijirikawa - Uta no Prince-sama                        r Jeremy Agriche - How to Protect the Heroine's Brother       
  c Toi Shiramitsu - 18TRIP                                     > c Aoi Hinami - Bottom-Tier Character Tomozaki                   c Fantaisie Impromptu - Takt. Op                              
  c Lihito Toudo - HANA-Doll                                    > c Autumn - Takt. Op                                             c Yuno Grinberryall - Black Clover                            
  c Flare Arlgrande Jioral - Redo of Healer                     > c Kira Sumeragi - Uta no Prince-sama                            c Shuro - Dungeon Meshi                                       
  c Kim Gong-Ja - SSS-Class Suicide Hunter                      > c Chang'e - Mobile Legends                                      c Martin Upmont - Gundam Series                               
  c Komugi - Hunter x Hunter                                    > c Mobius - Honkai Impact 3rd                                    r Jang Hayoung - Omniscient Reader's Viewpoint                
  c Lamb Spine Hotpot - Food Fantasy                              c Sumi Sakurasawa - Kanojo Okarishimasu                       > r Circe - Fate Series                                         
  c Giroro - Keroro                                             > c Privaty - NIKKE                                               c Reina Kousaka - Hibike! Euphonium                           
  c Spring - Takt Op. Series                                      c Shiro - Deadman Wonderland                                  > r Gaming - Genshin Impact                                     
  c Harriet - Yumekuro                                          > c Kuku - Heavenly Delusion                                      c V - Mystic Messenger                                        
  c Nanami Momozono - Kamisama Kiss                               c Itaru Shiodome - Nagi no Asukara                            > r Mia Whitlock - The Detective is Already Dead                
  c Kojiro Nanjo - SK8 the Infinity                             > c Yu Eunhee - Circles                                           c Momo Nishimiya - Jujutsu Kaisen                             
  c Reina Aharen - Aharen-san wa Hakarenai                      > c Kiroku Kinugawa - 18TRIP                                      c Yuu Nishinoya - Haikyuu!!                                   
  c Hanami - Jujutsu Kaisen                                       c Kirschtaria Wodime - Fate Series                            > c Herta - Honkai Star Rail                                    
> r Calcharo - Wuthering Waves                                    c Ushimaki Juri - Blue Archive                                  c Heihachi Mishima - Tekken Series                            
  r Finral Roulacase - Black Clover                               r Akane Hououji - Megami no Café Terrace                        c Regulus Corneas - Re:Zero                                   No Choice
  c Bounty Hunter - Dota Series                                 > c Theresa Apocalypse - Honkai Impact 3rd                        r Riho Tsukishima - Megami no Café Terrace                    
  c Retsu Kudou - The Irregular at Magic High School            > c Derrick Eckhart - Villains Are Destined to Die                c Benedict Blue - Violet Evergarden                           
  c Rio Tsukatsuki - Blue Archive                                 c Junko Enoshima - Danganronpa                                > r Hwaryun - Tower of God                                      
  c Kasumi Saegusa - The Irregular at Magic High School         > c Naomi Anderson - Tears of Themis                              c Lucas Proust - Shuuen no Virche                             
  c Tuxam - Fragaria Memories                                   > c Rouji Chante - Gundam Series                                  c Tsukasa Shishio - Dr. Stone                                 
  c Qiao Ling - Link Click                                      > c Gobta - Tensei Shitara Slime Datta Ken                        c Sachi Komine - Grisaia no Kajitsu                           
  c Tanjiro Kamado - Demon Slayer                                 c Azusa Nakano - K-On!                                        > r Akari Watanabe - Fuufu Ijou, Koibito Miman                  
> r Arianna - Loner Life in Another World                         c Fubuki - The Elusive Samurai                                  c Edgar Redmond - Black Butler                                
  c Ada Wong - Biohazard                                        > c Sugitani Zenkubo - Fate Series                                c Ruka Sarashina - Kanojo Okarishimasu                        
> r Garam Jahad - Tower of God                                    c Nodoka Toyohama - Seishun Buta Yarou                          c Kaede Naruse - Shikizakura                                  
  c AE3803 - Cells at Work!                                       c Kirie Konami - World Trigger                                > r Xie Lian  Hua Cheng - Heaven Official's Blessing            
  c Chidori Yoshino - Persona Series                            > c Alatreon - Monster Hunter Series                              c Azure - Alchemy Stars                                       
  c Faputa - Made in Abyss                                      > c Tenka Izumo - Mato Seihei no Slave                            c Leorio Paladiknight - Hunter x Hunter                       
  c Gray Fullbuster - Fairy Tail                                  c Ryusei Shido - Blue Lock                                    > r Shilial Lo Po Bia Jahad - Tower of God                      
  c Milim Nava - Tensei Shitara Slime Datta Ken                 > c Tomohiro Nagatsuka - A Silent Voice                           c Shuuya Kano - Mekakucity Actors                             
  c Shimamura Hougetsu - Adachi to Shimamura                      r S-Shark - One Piece                                           r Nocturne - League of Legends                                No Choice
  c Hana Yurikawa - Mieruko-chan                                > c Penguin? - Sumikko Gurashi                                    c Taylor - Queen's Blade                                      
  c Ume Hanami - The iDOLM@STER Series                          > c Atri - Atri -My Dear Moments-                                 c Yhwach - Bleach                                             
> r Amau Ako - Blue Archive                                       c Sense - Sousou no Frieren                                     c Yuichi Katagiri - Tomodachi Game                            
> r White - Tower of God                                          c Tanukikouji Kinu - My Deer Friend Nokotan                     c Di Renjie - Honor of Kings                                  
  c Brewmaster - Dota Series                                    > c Shun Miller - Katsute Mahou Shoujo                            c Klarkstella - Fragaria Memories                             
  c Isuzu Sento - Amagi Brilliant Park                          > c Silas Karlisle - Beyblade Series                              c Rinne Amagi - Ensemble Stars                                
  c Shinobu Wakamiya - Chihayafuru                              > c Murray - Sly Cooper                                           c Shion - Tensei Shitara Slime Datta Ken                      
  c HiMERU - Ensemble Stars                                     > c Kurumi Haraga - Hyakkano                                      c Widowmaker - Overwatch                                      
> c Jing Yuan - Honkai Star Rail                                  c Nikolai Gogol - Bungou Stray Dogs                             r Medb - Fate Series                                          
  c Retasu Midorikawa - Tokyo Mew Mew                           > c Saemonza - Girls und Panzer                                   c Obsidian - Houseki no Kuni                                  
  c Itsuki - Yumekuro                                           > c Lylia - Mobile Legends                                        c Wang Xue - World Dai Star                                   
  c Anisphia Wynn Palettia - Tenten Kakumei                       c Mini Yaemori - Kanojo Okarishimasu                          > r Akari Watanabe - Fuufu Ijou, Koibito Miman                  
  c Kirika Akatsuki - Senki Zesshou Symphogear                  > c Campanella - Takt. Op                                         c Koshi Anko - My Deer Friend Nokotan                         
  c Superalloy Darkshine - One Punch Man                        > c Percival Freeman - Tears of Themis                            c Satsuki Ito - Paradox Live                                  
  c Brimstone - VALORANT                                        > c Jun Wu - Heaven Official's Blessing                           c Yuri Alpha - Overlord                                       
  c Towa - Slow Damage                                          > c Kimie Kamata - Oresuki                                        c Tsuchinoko - Kemono Friends                                 
  c Asaka Mayama - Oresuki                                        r Qiu Tong - Tamen De Gushi                                     r Ouka Makuzawa - Megami no Café Terrace                      No Choice
  c Kuromi - Sanrio Series                                      > c Liang Yue - Reverse: 1999                                     c Arisa Kuhouin - Guilty Crown                                
> c Barbara Pegg - Genshin Impact                                 c Lucas Proust - Shuuen no Virche                               c Aira Shiratori - Ensemble Stars!                            
  c Koharu Hidaka - High Score Girl                             > c Yonah - NieR Series                                           c Miyo Saimori - My Happy Marriage                            
  c Takane Takamine - Haite Kudasai, Takamine-san               > c Rafayel - Love and Deepspace                                  c Lucifer - Obey Me!                                          
  c Kaoruko Jinnouchi - My Happy Marriage                       > c J - Reverse: 1999                                             c Valentina Azuma - Megami no Café Terrace                    
  c HiMERU - Ensemble Stars                                     > c Michiru Kagemori - Brand New Animal                           c Ziping Yin - Naraka: Bladepoint                             
  c Lucio - Overwatch                                           > c Kuya - NU: Carnival                                           c Masato Hijirikawa - Uta no Prince-sama                      
  c Miharu Ayase - Seirei Gensouki                              > c Will Serfort - Wistoria: Wand and Sword                       c Miku Izayoi - Date a Live                                   
  c Shi QIngxuan - Heaven Official's Blessing                   > c Morgana - League of Legends                                   c Rigoletto - Takt Op. Series                                 
  c Moonlight - Takt Op. Series                                 > c Shimei Ryomou - Ikkitousen                                    c Calcharo - Wuthering Waves                                  
  r Ouka Makuzawa - Megami no Café Terrace                        r White - Tower of God                                          r Rin Ko - Kingdom                                            No Choice
  c Coffee - Food Fantasy                                       > c Lin Zhaoyu - Honkai Impact 3rd                                c Lieutenant Trey - Monsuno                                   
  c Eiichi Ootori - Uta no Prince-sama                          > c White Rum - Reverse: 1999                                     c Tae Hanazono - BanG Dream!                                  
  c Willem Kmetsch - SukaSuka                                   > c Mei - Overwatch                                               c Mei Hatsume - My Hero Academia                              
  c Bolero - Takt. Op                                           > c Teru Minamoto - Toilet-Bound Hanako-Kun                       c Meliodas - Nanatsu no Taizai                                
  c Kamiki Shinobu - Princess Connect! Re:Dive                  > c Do Rae-Mi - A Pervert's Daily Life                            c Yukina Minato - BanG Dream!                                 
  c Tobio Kageyama - Haikyuu!!                                  > c Tracer - Overwatch                                            c Sugoroku Mutou - Yu-Gi-Oh!                                  
  c Jirou Yakuin - Fuufu Ijou, Koibito Miman                      c Shi QIngxuan - Heaven Official's Blessing                   > r Ouka Makuzawa - Megami no Café Terrace                      
  c Deadlock - VALORANT                                           c Suzu Narumiya - IDOLY PRIDE                                 > r Mia Whitlock - The Detective is Already Dead                
> r Jack - One Piece                                              c Yakumo Kokonoe - The Irregular at Magic High School           c Kusuri Yakuzen - Hyakkano                                   
  c Death Prophet - Dota Series                                 > c Twinkle Star - Takt Op. Series                                c Elma - Miss Kobayashi's Dragon Maid                         
  c Fuyutsuki - The Ice Guy and His Cool Female Colleague       > c Ren Saionji - MF Ghost                                        c Makabe Masamune - Masamune-kun no Revenge                   
  c Michiru Matsushima - Grisaia no Kajitsu                     > c Burnice White - Zenless Zone Zero                             c Yuugi Mutou - Yu-Gi-Oh!                                     
  c Takeo Gouda - My Love Story!!                               > c Meiko Ootsuka - Yamada-kun and the Seven Witches              c Otori Kaede - Komi Can't Communicate                        
  c Aichi Sendou - Cardfight!! Vanguard                         > c Saori Takebe - Girls und Panzer                               c Saori Joumae - Blue Archive                                 
  c Ryunosuke Tanaka - Haikyuu!!                                  c Tazaki - Joker Game                                         > r Veliona - Honkai Impact 3rd                                 
  c Saltherine Aldarake - Peach Boy Riverside                   > c Ayumi Yamagou - Girls und Panzer                              c Asagi Igawa - Taimanin Series                               
> r Shilial Lo Po Bia Jahad - Tower of God                        c Shiori Goshiki - Otonari ni Ginga                             c Anne Shelley - My Next Life as a Villainess                 
  c Mao Ukyo - Break My Case                                    > c Hana Isuzu - Girls und Panzer                                 c Shouma Toriashi - Raise wa Tanin ga Ii                      
  c Rintarou and Kaoruko - Kaoru Hana wa Rin to Saku            > c Till Nys - Gundam Series                                      c Keyaruga - Redo of Healer                                   
  c Kleken - Alchemy Stars                                      > c Kiritsugu Emiya - Fate Series                                 c Hwang Dong-Su - Solo Leveling                               
  c Shinji Hirako - Bleach                                      > c Yukari Akiyama - Girls und Panzer                             c Rika Furude - Higurashi                                     
  c Saori Joumae - Blue Archive                                   c Shiragiku Ono - Megami no Café Terrace                      > r Izumi Miyamura - Horimiya                                   
  c Natsuko Hirose - Zenshuu.                                   > c Lloyd de Saloum - Dainanaoji                                  c Tuka Luna Marceau - Gate                                    
  c Junko Enoshima - Danganronpa                                > c Enchantress - Dota Series                                     c My Melody - Sanrio Series                                   
  c Aphrodite - Hades                                           > c Kotaro Bokuto - Haikyuu!!                                     c Kanade Ooe - Chihayafuru                                    
  c Shiro - Deadman Wonderland                                  > c Luocha - Honkai Star Rail                                     c Brimstone - VALORANT                                        
  c Passionlip - Fate Series                                      c Regulus - Reverse: 1999                                     > c Clorinde - Genshin Impact                                   
  c Naberius Kalego - Mairimashita! Iruma-kun                   > c Summer - Takt Op. Series                                      c Lagiacrus - Monster Hunter Series                           
  c Lilith Asami - Trinity Seven                                > c Barbara Pegg - Genshin Impact                                 c Futaba Yozakura - Yozakura-san Chi no Daisakusen            
> c Bronya Rand - Honkai Star Rail                                c Aoba Wakura - Mato Seihei no Slave                            c Anton Ivanov - Zenless Zone Zero                            
  c Teruki Hanazawa - Mob Psycho 100                              c Free De La Hoya - Beyblade Series                           > c Li Sushang - Honkai Impact 3rd                              
  sr Kanroji Mitsuri - Demon Slayer                               r Naofumi  Raphtalia - The Rising of the Shield Hero            c Rui Tachibana - Domestic Girlfriend                         No Choice
  c Akemi Homura - Puella Magi Madoka Magica                    > c Meninas McAllon - Bleach                                      c Nergigante - Monster Hunter Series                          
  c Yuki Soma - Fruits Basket                                     c Medusa (Rider) - Fate Series                                > r Yihdra  Teltina - Sentai Red Isekai de Boukensha ni Naru    
  c Pennel - Villains Are Destined to Die                       > c Koishi Komeiji - Touhou                                       c Han Sooyong - Omniscient Reader's Viewpoint                 
  c Dororo - Keroro                                               c Yuuki Utsugi - Girls und Panzer                             > r Miss Fortune - League of Legends                            
  r Tomoe  Cherino - Blue Archive                                 r Charlotte Linlin - One Piece                                  r Tougou Asagaki - Sentai Red Isekai de Boukensha ni Naru     No Choice
  c Tomohiro Nagatsuka - A Silent Voice                         > c Sasha Blouse - Attack on Titan                                c Fyshe  Blundell - Tensai Ouji no Akaji                      
  c Nazuna Nito - Ensemble Stars!                               > c Hiyori Iki - Noragami                                         c Cid Kagenou (Shadow) - The Eminence in Shadow               
  c Yui Yuigahama - My Teen Romantic Comedy SNAFU                 c Rinne Amagi - Ensemble Stars                                > r Monika  Yuri - Doki Doki Literature Club                    
  c Reina Richter - Tears of Themis                               c Sinbad - Magi: The Labyrinth of Magic                       > r Yasuo - League of Legends                                   
> r Tomoe  Cherino - Blue Archive                                 c Cú Chulainn (Lancer) - Fate Series                            c Nikki - Nikki Series                                        
  c Mumen Rider - One Punch Man                                 > c Chiaki Morisawa - Ensemble Stars!                             c Aira Shiratori - Ensemble Stars!                            
  c Lululee Ashford - Girumasu                                  > c Fujieda Ryo - Slow Damage                                     c Iroha Isshiki - My Teen Romantic Comedy SNAFU               
  c Kojuurou Shuri - Masamune-kun no Revenge                    > c Miyoshi Takane - Blue Archive                                 c Jaehee Kang - Mystic Messenger                              
> r Suzaku  Lelouch - Code Geass                                  c Lu Gonghu - The Irregular at Magic High School                c Mai Kawai - Police in a Pod                                 
  c Kaede Kayano - Assassination Classroom                      > c Noire - Reverse: 1999                                         c Yakumo - NU: Carnival                                       
  c Yae Kokonoe - Isekai Smartphone                               c Iroha Isshiki - My Teen Romantic Comedy SNAFU               > r Kaju Noichigo - Acro Trip                                   
  c Mashirao Ojiro - My Hero Academia                           > c Umaru Doma - Himouto! Umaru-chan                              c Madara Mikejima - Ensemble Stars                            
  c Ikki - Amnesia                                              > c Sans - Undertale                                              c Eine kleine Nachtmusik - Takt. Op                           
  c Satsuki Ito - Paradox Live                                    c Edmund - NU: Carnival                                         sr Mash Burnedead - Mashle                                    No Choice
  c Mei Meido - Hyakkano                                          c Yuna Amagami - Tying the Knot with an Amagami Sister        > r Toi Shiramitsu - 18TRIP                                     
  c Gyro Zeppeli - JoJo's Bizarre Adventure                     > c Dori - Genshin Impact                                         r Ami Tsuruga - Megami no Café Terrace                        
  c Julius Juukulius - Re:Zero                                    c Matsuboshi Raidou - Aharen-san wa Hakarenai                 > r Mao Isara - Ensemble Stars!                                 
  c Gudetama - Gudetama                                         > c Privaty - NIKKE                                               c Ozu - Under Ninja                                           
> c Sonetto - Reverse: 1999                                       c Ophelia - Vivy: Fluorite Eye's Song                           r Licia Pleide - Tensei Kizoku, Kantei Skill de Nariagaru     
  c Yuusuke Urameshi - Yu Yu Hakusho                            > c Shokeika Deshi - Akudama Drive                                c Momonga - Chiikawa                                          
  c Miku - Gokushufudou                                         > c Killjoy - VALORANT                                            c Muni Ohnaruto - D4DJ                                        
  c Yuragi Kanno - Break My Case                                > c Tet - No Game No Life                                         c Hyde - Beyblade Series                                      
  c Naori Jinguuji - Futakire                                   > r Dunyarzad Homayani - Genshin Impact                           r Lu Guang  Cheng Xiaoshi - Link Click                        
  c Kyoko Kirigiri - Danganronpa                                > c Coconut - Nekopara                                            c Anna Yamada - The Dangers in My Heart                       
  r Baylord Yama - Tower of God                                   c Death Prophet - Dota Series                                 > c Hanya - Honkai Star Rail                                    
  c Lee Sin - League of Legends                                 > c Lucas Proust - Shuuen no Virche                               c Suiseiseki - Rozen Maiden                                   
  c Miku - Gokushufudou                                         > c Tails - Sonic X                                               c Fatalis - Monster Hunter Series                             
  c Kafka Hibino - Kaiju No. 8                                  > c Renatus Revol - Mashle                                        c Hacker - Akudama Drive                                      
  c Aya Rindo - Undead Girl Murder Farce                          c Wataru Hibiki - Ensemble Stars!                             > r Yoo Sangah - Omniscient Reader's Viewpoint                  
  c Nene Odagiri - Yamada-kun and the Seven Witches             > c A Knight - Reverse: 1999                                      c Shirayuki - Akagami no Shirayuki-hime                       
  c Elianna Bernstein - Bibliophile Princess                    > c Rin Nanakura - Giji Harem                                     c Toshiro Hitsugaya - Bleach                                  
  c RX-0 Unicorn - Gundam Series                                > c Polka Shinoyama - Dead Mount Death Play                       c Karen Himemiya - Make Heroine ga Oosugiru                   
  c Ukyo Asahina - Brothers Conflict                            > c Noel Niihashi - Burn the Witch                                c Agito Tyrone - Mashle                                       
> r Raiden Shogun, Zhongli, and Venti - Genshin Impact            c Sakura Kouno - Horimiya                                       c Enigma - Takt. Op                                           
  c Regina Mercedes - Seiken Maken                              > c Yoigahama Mitsuki - Princess Connect! Re:Dive                 c Mai-Mai - In the Land of Leadale                            
> r Chevreuse and Ayaka - Genshin Impact                          r Camille - League of Legends                                   c Valt Aoi - Beyblade Series                                  
> r Yihdra  Teltina - Sentai Red Isekai de Boukensha ni Naru      c Beastmaster - Dota Series                                     c Beatrice - Umineko Series                                   
  c Daphnis & Chloe - Takt. Op                                  > c Doctor Eggman - Sonic X                                       c Mafuyu Hoshikawa - Blend S                                  
  c L Lawliet - Death Note                                      > c Aoi Sakurai - Rail Wars                                       c Ryuunosuke Akutagawa - Bungou Stray Dogs                    
> r Megu  Kasumi - Blue Archive                                   c Zayne - Love and Deepspace                                    c Kamisaman - Magicami                                        
  c Naberius Kalego - Mairimashita! Iruma-kun                   > c Li Sushang - Honkai Impact 3rd                                c Ronald Knox - Black Butler                                  
  c Ayn Alwyn - Lovebrush Chronicles                            > c Marcus - Reverse: 1999                                        r Qiu Tong - Tamen De Gushi                                   
  c Rathian - Monster Hunter Series                             > c Himari Kino - Whisper Me a Love Song                          c Bu-Ling Huang - Tokyo Mew Mew                               
  c Yumeko Shikiya - Make Heroine ga Oosugiru!                    c Mizutsune - Monster Hunter Series                           > c Regulus - Reverse: 1999                                     
  c James Sunderland - Silent Hill Series                       > c Rio Tsukatsuki - Blue Archive                                 c Gragas - League of Legends                                  
  c Gouketsu - One Punch Man                                      c Nephren Ruq Insania - SukaSuka                              > r Viktor - League of Legends                                  
  c Nana - Darling in The Franxx                                > c Karen Matsugazaki - Tying the Knot with an Amagami Sister     c Nate River - Death note                                     
  c Bolero - Takt. Op                                           > c Misaki Ayuzawa - Maid Sama!                                   c Harunobu Kazama - The Irregular at Magic High School        
  c Rosetta - Granblue Fantasy                                  > c Riselia Ray Crystalia - Seiken Maken                          c Tifa Lockheart - Final Fantasy Series                       
  c Kakeru Miwa - Shikizakura                                   > c Karen Himemiya - Make Heroine ga Oosugiru                     c Moca Aoba - BanG Dream!                                     
  r Douma and Kotoha - Demon Slayer                               r Lisa Imai - BanG Dream!                                       c Panda - Jujutsu Kaisen                                      No Choice
  r Tomoe  Cherino - Blue Archive                                 r Megu  Kasumi - Blue Archive                                   c Flare Arlgrande Jioral - Redo of Healer                     No Choice
> c Beidou - Genshin Impact                                       c Jupiter - Takt. Op                                            r Yuki Nagato - Suzumiya Haruhi no Yuuutsu                    
  c Maya Yotsuba - The Irregular at Magic High School           > c Leo Tsukinaga - Ensemble Stars                                c Genzo Wakabayashi - Captain Tsubasa                         
  r Haruhi Suzumiya - Suzumiya Haruhi no Yuuutsu                  r Marika Tachibana - Nisekoi                                    c Vyn Richter - Tears of Themis                               No Choice
  c Donna Beneviento - Biohazard                                > c Teresa - Claymore                                             c Ethan Winters - Biohazard                                   
  c Kirito - Sword Art Online                                   > c JUNKY - Gray Sheep                                            c Reki Kyan - SK8 the Infinity                                
> r Douma and Kotoha - Demon Slayer                               c Yue - Arifureta                                               c Devola  Popola - NieR Series                                
  c Mare Bello Fiore - Overlord                                 > c Yukina Minato - BanG Dream!                                   c Chinatsu Kano - Blue Box                                    
  c Aubrey - Omori                                              > c Sombra - Overwatch                                            c La Mer - Takt Op. Series                                    
  c Guts & Casca - Berserk                                      > c Elise - Takt. Op                                              c Miki Kawai - A Silent Voice                                 
> c Hare - Honkai Impact 3rd                                      c Shiranui Mai - King of Fighters                               r Maki Inohara - Grisaia: Phantom Trigger                     
  c Atsuya Baba - Odd taxi                                      > c Chika Komari - Make Heroine ga Oosugiru                       c Shisa - Chiikawa                                            
  c Junko Konno - Zombieland Saga                               > c Carmelita Fox - Sly Cooper                                    c Kim Sangshik - Solo Leveling                                
  c Tsukasa Suou - Ensemble Stars                               > c Tadano Hitohito - Komi Can't Communicate                      c Ramona Wolf - World Dai Star                                
  r Ruri and Naomi - Hello World                                  r Izumi Miyamura - Horimiya                                     c Enchantress - Dota Series                                   No Choice
  c Nagisa Shiota - Assassination Classroom                     > c Ako Tamaki - Netoge no Yome                                   c Euphyllia Magenta - Tenten Kakumei                          
  c Rin Shima - Yuru Camp                                         c Momo Deviluke - To Love Ru                                  > r Jeremy Agriche - How to Protect the Heroine's Brother       
  c Cyclops - Mobile Legends                                      r Jeremy Agriche - How to Protect the Heroine's Brother         r Toya Aoyagi - Project Sekai                                 No Choice
> r White - Tower of God                                          c Gamma - The Eminence in Shadow                                c Moca Aoba - BanG Dream!                                     
  c Ken Takakura - Dandadan                                     > c Sugar - NIKKE                                                 c Ichigo Momomiya - Tokyo Mew Mew                             
> r Doma - One Piece                                              c Ebifurai-no-shippo - Sumikko Gurashi                          c 707 - Mystic Messenger                                      
> r Sylvia Pedelian - How to Protect the Heroine's Older Brother   c Gohan - Dragon Ball                                           c Tamaki Amajiki - My Hero Academia                           
  c Ivern - League of Legends                                   > c Izumi Miyamura - Horimiya                                     c Himuro - The Ice Guy and His Cool Female Colleague          
  sr Mei Misaki - Another                                         c Coyote Stark - Bleach                                         c Shigure Soma - Fruits Basket                                No Choice
  c Ithea Myse Valgulious - SukaSuka                            > c Ooka Myoujin - Shikizakura                                    c Rena Erindel - Elsword                                      
  sr Yuzuriha - Jigokuraku                                        c Sasha Necron - Misfit of Demon King Academy                   c Di Renjie - Honor of Kings                                  No Choice
  c Mimori Mizuha - Blue Archive                                > c Lingyang - Wuthering Waves                                    c Koneko Toujou - High School DxD                             
  c Mimori Mizuha - Blue Archive                                > c Lingyang - Wuthering Waves                                    c Koneko Toujou - High School DxD                             
  c Furohonya - Chiikawa                                        > c Sebas Tian - Overlord                                         c Dia Viekone - Ansatsu Kizoku                                
  c Chuatury Panlunch - Gundam Series                             c Kazuya Mishima - Tekken Series                              > r Evelynn - League of Legends                                 
  c Kumiko and Reina - Hibike! Euphonium                        > c Lila Decyrus - Atelier Ryza                                   c Raphael Walt - My Next Life as a Villainess                 
  c Anna Yanami - Make Heroine ga Oosugiru!                     > c Rinsha Fana - Dungeon Meshi                                   c Miho Shirakawa - Odd Taxi                                   
  c Red Queen - Isekai Shokudou                                 > c Tsugaru Shinuchi - Undead Girl Murder Farce                   c Shirokuma - Sumikko Gurashi                                 
> c Albedo - Genshin Impact                                       c Petra Itta - Gundam Series                                    c Theoto Rikka - Eighty-Six                                   
  c Orochi Ginba - Beyblade Series                                c Subaru Akehoshi - Ensemble Stars!                           > c Fu Hua - Honkai Impact 3rd                                  
  c Izumi Miyamura - Horimiya                                     r Natsuko  Luke - Zenshuu.                                      r Camille - League of Legends                                 No Choice
  c Ryo Ishizaki - Captain Tsubasa                              > c Pennel - Villains Are Destined to Die                         c Shuu Ouma - Guilty Crown                                    
  c Neuvillette - Genshin Impact                                  c May - Alchemy Stars                                           r Yoimiya and Kazuha - Genshin Impact                         No Choice
> r Moa Son - I Stole the First Ranker's Soul                     c Monika - Spy Classroom                                        c Karen Inukai - My Life as Inukai-san's Dog                  
> r Lyney and Lynette - Genshin Impact                            c Hange Zoe - Attack On Titan                                   c Camus - Uta no Prince-sama                                  
  c Tomoe Udagawa - BanG Dream!                                 > c Alexandrov Grigorovich - Plunderer                            c Rin Shinomiya - The Dreaming Boy is a Realist               
  r Camille - League of Legends                                   r Akane Hououji - Megami no Café Terrace                        c SNOW - Gray Sheep                                           No Choice
  c Ichinose Tokiya - Uta no Prince-sama                        > c Towa - Slow Damage                                            c Sasha Necron - Misfit of Demon King Academy                 
  c Di Renjie - Honor of Kings                                  > c Zen Gaho - Paradox Live                                       c Unvollendete - Takt Op. Series                              
  c Kenyu Yukimiya - Blue Lock                                    c Usagi Tsukino - Sailor Moon                                 > r Medb - Fate Series                                          
> r Verina - Wuthering Waves                                      c Hideyoshi Nagachika - Tokyo Ghoul                             c Beatrice - Re:Zero                                          
  c Ozu - Under Ninja                                           > c Camie Utsushimi - My Hero Academia                            c Rindo Kobayashi - Food Wars!                                
  c Anne Shelley - My Next Life as a Villainess                 > c Illari - Overwatch                                            c Mayuri Kurotsuchi - Bleach                                  
  c Yahaba - Demon Slayer                                       > c Beru - Solo Leveling                                          c Naberius Kalego - Mairimashita! Iruma-kun                   
> r Baylord Yama - Tower of God                                   c Lucifer - Obey Me!                                            c Rinrin Shinomiya - Himitsu no AiPri                         
  c Hachiware - Chiikawa                                        > c Dracule  Mihawk - One Piece                                   c Chilchuck Tims - Dungeon Meshi                              
  r Megumi  Touka - Grisaia: Phantom Trigger                    > r Yoimiya and Kazuha - Genshin Impact                           c Yukikaze Kamina - 18TRIP                                    
  c Dominique de Sade - Vanitas no Karte                          c Yumiko Sakaki - Grisaia no Kajitsu                          > r Rin Ko - Kingdom                                            
  c Nimaiya Oetsu - Bleach                                      > c Chiikawa - Chiikawa                                           c JOE - Gray Sheep                                            
  c Sucrose - Genshin Impact                                      c Mika - Genshin Impact                                         c Albert Hawke - Saint's Magic Power                          No Choice
  c Shura Kirigakure - Blue Exorcist                            > c Swain - League of Legends                                     c Blade - NU: Carnival                                        
  c Shinji Ikari - Neon Genesis Evangelion                        c Sakura Minamoto - Zombieland Saga                           > r Witches - Little Witch Academia                             
  r Rin Okumura - Blue Exorcist                                   r Verina - Wuthering Waves                                      c Heroine - Amnesia                                           No Choice
  c Rupa - Girls Band Cry                                       > c Estelle Marino - Tears of Themis                              c Kanaria - Rozen Maiden                                      
  c Leon Kennedy - Biohazard                                    > c Mei Hayasaka - IDOLY PRIDE                                    c Akihiko Kaji - Given                                        
  c Hiro Shinosawa - The iDOLM@STER Series                      > c Han Nari - Circles                                            c Ken Midori - Beyblade Series                                
  c Eiko Houzuki - Dark Gathering                                 c Brewmaster - Dota Series                                    > r Xie Lian  Hua Cheng - Heaven Official's Blessing            
  c Hiyori Tomoe - Ensemble Stars                               > c Julius Novachrono - Black Clover                              c Armin Arlert - Attack on Titan                              
  c Kirishima Miyama - Raise wa Tanin ga Ii                       c Azusa Aizawa - Slime Taoshite 300-nen                       > r Dr. MEI and Kevin Kaslana - Honkai Impact 3rd               
> c Toya Aoyagi - Project Sekai                                   c Baraggan Louisenbairn - Bleach                                c Rammus - League of Legends                                  
> c Rita Rossweisse - Honkai Impact 3rd                           c Rathian - Monster Hunter Series                               c Akali - League of Legends                                   
  c Anna Yanami - Make Heroine ga Oosugiru!                     > c Fuuka Aikiyo - Blue Archive                                   c Brimstone - VALORANT                                        
  c Jonathan Price - Call Of Duty Series                        > c Nodoka Yagi - Selection Project                               c Tsugumi - Guilty Crown                                      
  c Azuki - Nekopara                                            > c Darius Morgan - Tears of Themis                               c Rin Shima - Yuru Camp                                       
> c Sotheby - Reverse: 1999                                       c Madarame Kei - Slow Damage                                    r Yuno Grinberryall - BlackClover                             
  c Watchdog Man - One Punch Man                                > c Obito Uchiha - Naruto                                         c Yumeko Shikiya - Make Heroine ga Oosugiru!                  
  c Makoto Kikuchi - The iDOLM@STER Series                      > c Yuta Aoi - Ensemble Stars                                     c Haruko Yamada - Shikizakura                                 
  c Joey Wheeler - Yu-Gi-Oh!                                    > c Echidna - Re:Zero                                             c Dino - Blend S                                              
  c Toko Fukawa - Danganronpa                                     c Mizutsune - Monster Hunter Series                           > r Miss Fortune - League of Legends                            
  c Edmund - NU: Carnival                                         c Saki Kawasaki - My Teen Romantic Comedy SNAFU               > r Natalia - Mobile Legends                                    
  c Mao Takasaki - Megami no Café Terrace                       > c Ryou Yamada - Bocchi the Rock!                                c Kamiki Shinobu - Princess Connect! Re:Dive                  
  sr Lu Guang  Cheng Xiaoshi - Link Click                         c Reina Aharen - Aharen-san wa Hakarenai                        c Midori Takamine - Ensemble Stars!                           No Choice
  c Madara - Natsume Yuujinchou                                   c Takao Ameku - Ameku M.D.: Doctor Detective                  > r Team Urameshi - Yu Yu Hakusho                               
  c Rammus - League of Legends                                    r Dahliya Rossetti - Dahliya in Bloom                         > r Aether and Albedo - Genshin Impact                          
  c Shinya Kougami - PSYCHO-PASS                                > c Ume Ochazuke - Food Fantasy                                   c Pochita - My Life as Inukai-san's Dog                       
  c Sojourn - Overwatch                                         > c Winston - Overwatch                                           c Kanade Kanon - Vocaloid                                     
  c Hikari Mitsuriya - VTuber Legend                            > c Makoto - Bubble                                               c Khun Aguero Agnis - Tower of God                            
  c Kuro Kiryu - Ensemble Stars                                   c Kaiji Itou - Kaiji                                          > r Susannah and Seele Vollerei - Honkai Impact 3rd             
> c 37 - Reverse: 1999                                            c Flare Arlgrande Jioral - Redo of Healer                       c Sawako Kuronuma - Kimi ni Todoke                            
  c Takemichi Hanagaki - Tokyo Revengers                        > c Gilgamesh (Archer) - Fate Series                              c Sakura Akino - Oresuki                                      
  c Luo Yi - Mobile Legends                                       c Futaba Isurugi - Revue Starlight                            > r Amau Ako - Blue Archive                                     
  c Gabriel Tenma White - Gabriel DropOut                         c Makabe Masamune - Masamune-kun no Revenge                   > r Khun Maschenny Jahad - Tower of God                         
  c Yuuri Katsuki - Yuri!!! on Ice                              > c Brook - One Piece                                             c Tomoya Mashiro - Ensemble Stars                             
  c Maria Mikhailovna Kujou - Roshidere                         > c Fubuki - The Elusive Samurai                                  c Kisame Hoshigaki - Naruto                                   
  c Susanna Randall - My Next Life as a Villainess                c Sophie Neuenmuller - Atelier Sophie                         > r Hina  Licht - Plunderer                                     
  c Heroine - Amnesia                                           > c Milim Nava - Tensei Shitara Slime Datta Ken                   c Koneko Toujou - High School DxD                             
  c Zassou - Sumikko Gurashi                                    > c Mammon - Obey Me!                                             c Chaco - Fragaria Memories                                   
  c Eiji Kakihana - Odd Taxi                                    > c Mash Burnedead - Mashle                                       c Naoto Hachiouji - Ijiranaide, Nagatoro-san                  
  c Naoto Shirogane - Persona Series                              c Coffee - Food Fantasy                                       > r Douma and Kotoha - Demon Slayer                             
  c Sophie Neuenmuller - Atelier Sophie                           c Moge-ko - Mogeko Castle                                     > c Minori Hanasato - Project Sekai                             
> r Licia Pleide - Tensei Kizoku, Kantei Skill de Nariagaru       c Watchdog Man - One Punch Man                                  c Sakura Nanamine - Toilet-Bound Hanako-Kun                   
  c Doppo Kunikida - Bungou Stray Dogs                          > c Sword Maiden - Goblin Slayer                                  c Takumi Usui - Maid Sama!                                    
  c Gabriel Tenma White - Gabriel DropOut                       > c Beatrix - Mobile Legends                                      c Syr Flova - DanMachi                                        
> r Neon, Sage and Jett - VALORANT                                c Sylus - Love and Deepspace                                    c Satori Komeiji - Touhou                                     
  c Hisoka Morow - Hunter x Hunter                              > c Kishibe - Chainsaw Man                                        c Elfaria Albis Serfort - Wistoria: Wand and Sword            
  c Koharu Shimoe - Blue Archive                                > c Moonlight - Takt Op. Series                                   c Nico Robin - One Piece                                      
  c Nio Hashiri - Akuma no Riddle                               > c Derrick Eckhart - Villains Are Destined to Die                c Belphegor - Obey Me!                                        
  r Chinatsu and Taiki - Blue Box                                 r Nocturne - League of Legends                                  c Julis-Alexia von Riessfeld - The Asterisk War               No Choice
  c Uryuu Kamihate - Tying the Knot with an Amagami Sister      > c Jack-O' Valentine - Guilty Gear                               c Don Giovanni - Takt. Op                                     
  c Hikaru Matsuyama - Captain Tsubasa                          > c Tokaku Azuma - Akuma no Riddle                                c Medusa (Rider) - Fate Series                                
> r Hanamaruobake - Sanrio Series                                 c Red Queen - Isekai Shokudou                                   c Tsumugi Kotobuki - K-On!                                    
  c Midori Takamine - Ensemble Stars!                           > c flower - Vocaloid                                             c Feng Xin - Heaven Official's Blessing                       
  c Doctor Eggman - Sonic X                                     > c Mao Isara - Ensemble Stars!                                   c Kamisaman - Magicami                                        
  c Eine kleine Nachtmusik - Takt. Op                             c Hero - Omori                                                > c Druvis III - Reverse: 1999                                  
> r Keqing and Xiangling - Genshin Impact                         r Endorsi Jahad - Tower of God                                  c Zyra - League of Legends                                    
  c Darkness - KonoSuba                                         > c Tuxam - Fragaria Memories                                     c Sun Jing - Tamen De Gushi                                   
  c Rena Erindel - Elsword                                      > c Nadeko Sengoku - Monogatari Series                            c Miku - Gokushufudou                                         
  c Heroine - Amnesia                                           > c Rigoletto - Takt Op. Series                                   c Chris Redfield - Biohazard                                  
  c Badobarm - Fragaria Memories                                > c Ayako Mochizuki - The Elusive Samurai                         c Hina Sorasaki - Blue Archive                                
  c Iseria - Epic Seven                                         > c Jiji - Dandadan                                               c Kazuichi Arai - Kimi ni Todoke                              
  c Eichi Tenshouin - Ensemble Stars!                           > c Ayame Soma - Fruits Basket                                    c Hibiki - Bubble                                             
  c Ada - Boruto                                                > c Futaba Isurugi - Revue Starlight                              c Mamako Oosuki - Okaa-san Online                             
  c Tsugumi - Guilty Crown                                      > c Sotheby - Reverse: 1999                                       c Tachibana Hibiki - Senki Zesshou Symphogear                 
  c Tama Kurogane - DEN-ON-BU                                     c Zombieman - One Punch Man                                   > r Haruhi Suzumiya - Suzumiya Haruhi no Yuuutsu                
  c Devil Jin - Tekken Series                                   > c Jun Wu - Heaven Official's Blessing                           c Seto Kaiba - Yu-Gi-Oh!                                      
  c Tomo Aizawa - Tomo-chan is a Girl!                          > c Kawaki - Boruto                                               c Falin Touden - Dungeon Meshi                                
  c Orisa - Overwatch                                           > c Khun Aguero Agnis - Tower of God                              c Sakuta Azusagawa - Seishun Buta Yarou                       
  c Romero - Zombieland Saga                                    > c Umaru Doma - Himouto! Umaru-chan                              c Kei Tachikawa - World Trigger                               
  c Mao Isara - Ensemble Stars!                                   c Amu Hinamori - Shugo Chara!                                 > r Yaoyao and Qiqi - Genshin Impact                            
  c Miho Shirakawa - Odd Taxi                                   > c Kiyoshi Fujino - Prison School                                c La Mer - Takt Op. Series                                    
  c Touka Kirishima - Tokyo Ghoul                               > c Yangyang - Wuthering Waves                                    c Yoshiko Kyuumiya - The Daily Life of the Immortal King      
  c Astraea - Sora no Otoshimono                                > c Platelet - Cells at Work!                                     c Raze - VALORANT                                             
  c Lila Decyrus - Atelier Ryza                                   c Reaper - Overwatch                                          > c Lighter - Zenless Zone Zero                                 
  c Sein - Sousou no Frieren                                      c Soldier 11 - Zenless Zone Zero                              > r Yuri  Renge - Momentary Lily                                
  c Kyoko Kirigiri - Danganronpa                                  c Kakeru Sengoku - Horimiya                                   > r Tsugumi Hazawa - BanG Dream!                                
  r Cassis Pedelian - How to Protect the Heroine's Older Brother   r Monkey D. Garp - One Piece                                    r Finral Roulacase - Black Clover                             No Choice
  c Himari Aozora - Himitsu no AiPri                              c Penguin? - Sumikko Gurashi                                  > r Bane - Mobile Legends                                       
> r Lu Guang  Cheng Xiaoshi - Link Click                          c Senshi - Dungeon Meshi                                        c Yamada Elf - Eromanga Sensei                                
> r Veliona - Honkai Impact 3rd                                   r Sakura Haruka - Wind Breaker                                  c Kousuke Misaki - Tomo-chan Is a Girl!                       
  c Agito Tyrone - Mashle                                       > c Bellatrix - Katsute Mahou Shoujo                              c Tomoe - Kamisama Kiss                                       
> r Megumi  Touka - Grisaia: Phantom Trigger                      c Baishuo - Nikki Series                                        c Arlesienne - Takt. Op                                       
  c Pochacco - Sanrio Series                                    > c Tsubomi Kido - Mekakucity Actors                              c Kyoko Kirigiri - Danganronpa                                
  c Ryusui Nanami - Dr. Stone                                   > c Yuusuke Urameshi - Yu Yu Hakusho                              c Kaeru Yamatani - VTuber Legend                              
  c Chiaki Nanami - Danganronpa                                   c Stark - Sousou no Frieren                                   > r Xie Lian  Hua Cheng - Heaven Official's Blessing            
  c Kureha Clyret - Redo of Healer                                c Yuuri Katsuki - Yuri!!! on Ice                              > r Kamakiri - One Piece                                        
  c Penelope Eckhart - Villains Are Destined to Die             > c Obsidian - Houseki no Kuni                                    c Oryou - Girls und Panzer                                    
> r Finral Roulacase - Black Clover                               c Minori Hanasato - Project Sekai                               c Eta - The Eminence in Shadow                                
  c Ramattra - Overwatch                                          c Yayoi Houzuki - Dark Gathering                              > r Dahliya Rossetti - Dahliya in Bloom                         
  c Yuna Amagami - Tying the Knot with an Amagami Sister        > c Erwin - Girls und Paner                                       c Arcueid Brunestud - Tsukihime                               
  c Towa - Slow Damage                                          > c Sakura Akino - Oresuki                                        c Koga Oogami - Ensemble Stars                                
  c Ibara - Shikizakura                                         > c Sivir - League of Legends                                     c Laby - Elsword                                              
  c Rena Erindel - Elsword                                        c Kleken - Alchemy Stars                                      > r Yaoyao and Qiqi - Genshin Impact                            
  c Karen Aijou - Revue Starlight                               > c Shinobu Wakamiya - Chihayafuru                                c Richelieu - Kantai Collection                               
> r Verina - Wuthering Waves                                      c Nokk - Tom Clancy's Series                                    c Gobta - Tensei Shitara Slime Datta Ken                      
> r Han Sooyoung - Omniscient Reader's Viewpoint                  c Sukeban (MG) - Blue Archive                                   c Hina - Hinamatsuri                                          
> r Raiden Shogun, Nahida, and Venti - Genshin Impact             r Jeremy Agriche - How to Protect the Heroine's Brother         r Seele Vollerei - Honkai Impact 3rd                          
  c Osaragi - Sakamoto Days                                     > c Towa - Slow Damage                                            c Reo Mikage - Blue Lock                                      
  c Kohaku Oukawa - Ensemble Stars                                c Mahito - Jujutsu Kaisen                                     > r Twenty-Fifth Bam - Tower of God                             
> c Amber - Genshin Impact                                        c Jupiter - Takt. Op                                            c Astalos - Monster Hunter Series                             
  c Nana - Mobile Legends                                       > c Charlotte - Genshin Impact                                    c Melissa - Mobile Legends                                    
> r Veliona - Honkai Impact 3rd                                   c Ailine Weiss - Tears of Themis                                c Signal - NIKKE                                              
